################################|#&#|#################################
######@######################### ### ##########################@######
################################ ### #################################
######@   $       ############## ### ###############       $   @######
################################ ### ################## ##############
######@   $                      ###                       $   @######
################################ ### ################## ##############
######@   $       ############## ### ###############       $   @######
############################             #############################
-
############### ###################################### ###############
######@ #######@######################################@####### @######
####### ####### ###################################### ####### #######
######@ ####### ###################################### ####### @######
####### ####### ###################################### ####### #######
######@ #######$######################################$####### @######
####### ###################################################### #######
######@$                                                      $@######
######################################################################
##################################^###################################
